  R   1000 1000

   NO   shanks.xpm
SO ayoub.xpm 
WE maroc.xpm 
EA hani.xpm
S eagle.xpm



F 255,255,255
C 0,0,0


  11111111111111111111111
1111000010001111100000011111111111
111111000000000000000000000001
1000000000000000000000000000011111  
111110000000N0000000000000001
1000000000000000000000001111
1111111111111111111111111111
10000000000000000000000011111111
100000011111111000000000000000001
10000000000000000000000011111111
1000000000000000000000001
100000000000000000000001
111111111111111111111111111



